Sword = سيف
Master Sword = السيف الأسطوري
Bow = قوس
Shield = درع
Hylian Shield = درع هايليا
Arrow = سهم
Spear = رمح
Claymore = سيف عريض
Rod = عصا
Boomerang = بوميرانغ
Trident = رمح ثلاثي
Scepter = صولجان
Scimitar = سيف منحني
Blade = نصل
Dagger = خنجر
Hammer = مطرقة
Club = هراوة
Axe = فأس
Longsword = سيف طويل
Broadsword = سيف عريض
Apple = تفاحة
Mushroom = فطر
Ruby = ياقوتة
Sapphire = ياقوتة زرقاء
Diamond = ألماسة
Topaz = توباز
Opal = أوبال
Amber = كهرمان
Flint = صوّان
Wood = خشب
Rock Salt = ملح صخري
Luminous Stone = حجر مضيء
Star Fragment = شظية نجم
Fairy = جنية
Elixir = إكسير
Potion = جرعة
Meat = لحم
Fish = سمك
Fruit = فاكهة
Herb = عشبة
Flower = زهرة
Nut = جوزة
Honey = عسل
Butter = زبدة
Milk = حليب
Egg = بيضة
Rice = أرز
Wheat = قمح
Pumpkin = يقطين
Carrot = جزر
Radish = فجل
Pepper = فلفل
Salt = ملح
Sugar = سكر
Oil = زيت
Acorn = بلوطة
Rupee = روبية
Heart Container = وعاء قلب
Stamina Vessel = وعاء تحمل
Heart = قلب
Stamina = قدرة التحمل
Stamina Wheel = عجلة التحمل
Health = صحة
Defense = دفاع
Attack = هجوم
Durability = متانة
Damage = ضرر
Power = قوة
Speed = سرعة
Stealth = تخفي
Resistance = مقاومة
Ultrahand = اليد الفائقة
Fuse = الدمج
Ascend = الصعود
Recall = الاسترجاع
Autobuild = البناء التلقائي
Paraglider = المظلة الشراعية
Glider = المظلة
Camera = الكاميرا
Sensor = المستشعر
Scope = المنظار
Map = الخريطة
Shrine = مزار
Tower = برج
Skyview Tower = برج المراقبة السماوي
Lightroot = جذر النور
Temple = معبد
Dungeon = زنزانة
Cave = كهف
Well = بئر
Spring = ينبوع
Stable = إسطبل
Village = قرية
Town = بلدة
Castle = قلعة
Bridge = جسر
Lake = بحيرة
River = نهر
Mountain = جبل
Forest = غابة
Desert = صحراء
Volcano = بركان
Island = جزيرة
Ruins = أطلال
Depths = الأعماق
Surface = السطح
Sky = السماء
Korok = كوروك
Korok Seed = بذرة كوروك
Spirit Orb = جوهرة روحية
Zonai = زوناي
Zonai Device = جهاز زوناي
Zonai Charge = شحنة زوناي
Hyrule = هايرول
Hyrule Castle = قلعة هايرول
Hyrule Field = حقل هايرول
Death Mountain = جبل الموت
Zora's Domain = مملكة الزورا
Goron City = مدينة الغورون
Rito Village = قرية الريتو
Gerudo Town = بلدة الغيرودو
Kakariko Village = قرية كاكاريكو
Hateno Village = قرية هاتينو
Tarrey Town = بلدة تاري
Lookout Landing = مرسى المراقبة
Great Sky Island = جزيرة السماء الكبرى
Forgotten Temple = المعبد المنسي
Lost Woods = الغابة الضائعة
Great Fairy = الجنية العظيمة
Great Fairy Fountain = نافورة الجنية العظيمة
Zelda = زيلدا
Link = لينك
Ganondorf = غاننودورف
Ganon = غانون
Purah = بورا
Impa = إمبا
Sidon = سيدون
Yunobo = يونوبو
Tulin = تولين
Riju = ريجو
Rauru = راورو
Sonia = سونيا
Mineru = مينيرو
King = ملك
Queen = ملكة
Princess = أميرة
Hero = بطل
Champion = بطل
Sage = حكيم
Demon King = ملك الشياطين
Soldier = جندي
Guardian = حارس
Traveler = مسافر
Merchant = تاجر
Cooking = طبخ
Cook = اطبخ
Recipe = وصفة
Ingredient = مكوّن
Meal = وجبة
Effect = تأثير
Buff = تعزيز
Armor = درع
Helm = خوذة
Tunic = سترة
Greaves = واقي ساق
Boots = حذاء
Set Bonus = مكافأة الطقم
Upgrade = ترقية
Enchantment = سحر
Dye = صبغة
Material = مادة
Bundle = حزمة
Inventory = المخزون
Pouch = الحقيبة
Equipment = المعدات
Quest = مهمة
Main Quest = المهمة الرئيسية
Side Quest = مهمة جانبية
Shrine Quest = مهمة مزار
Side Adventure = مغامرة جانبية
Adventure = مغامرة
Mission = مهمة
Objective = هدف
Reward = مكافأة
Complete = مكتمل
Accept = قبول
Decline = رفض
Travel = سفر
Fast Travel = سفر سريع
Warp = انتقال سريع
Save = حفظ
Load = تحميل
Continue = متابعة
Settings = الإعدادات
Options = خيارات
Difficulty = صعوبة
Normal = عادي
Master Mode = الوضع الأسطوري
Gloom = ظلام
Gloom Hands = أيدي الظلام
Blood Moon = قمر الدم
Malice = حقد
Colgera = كولجيرا
Marbled Gohma = غوما المرمرية
Mucktorok = ماكتوروك
Queen Gibdo = ملكة غيبدو
Seized Construct = الآلة المحتلة
Phantom Ganon = غانون الشبح
Lynel = لاينل
Hinox = هاينوكس
Talus = تالوس
Molduga = مولدوغا
Gleeok = غليوك
Bokoblin = بوكوبلين
Moblin = موبلين
Lizalfos = ليزالفوس
Gibdo = غيبدو
Like Like = لايك لايك
Horriblin = هوريبلين
Boss Bokoblin = بوكوبلين قائد
Stalnox = ستالنوكس
Frox = فروكس
Flux Construct = آلة التدفق
Battle Talus = تالوس القتال
Throw = رمي
Attach = تثبيت
Detach = فك
Pick Up = التقاط
Drop = إسقاط
Use = استخدام
Equip = تجهيز
Unequip = إزالة التجهيز
Examine = فحص
Talk = تحدث
Open = فتح
Close = إغلاق
Yes = نعم
No = لا
OK = حسناً
Cancel = إلغاء
Confirm = تأكيد
Back = رجوع
Next = التالي
Previous = السابق
Lanayru = لناييرو
Necluda = نيكلودا
Akkala = أكالا
Hebra = هيبرا
Central Hyrule = وسط هايرول
East Necluda = شرق نيكلودا
Lanayru Great Spring = ينبوع لناييرو العظيم
Akkala Ancient Tech Lab = مختبر أكالا التقني القديم
Hebra Mountains = جبال هيبرا
Hyrule Lake = بحيرة هايرول
Trilby Valley = وادي تريلبي
Deeling Plain = سهل ديلينج
Lake Hylia = بحيرة هايليا
Faron Forest = غابة فارون
Lanayru Wetlands = أراضي لناييرو الرطبة
Zora's Fountain = نافورة الزورا
Zora River = نهر الزورا
Zora River Lower Course = مجرى نهر الزورا السفلي
Zora's Waterfall = شلال الزورا
Wellspring Isles = جزر الينبوع
Hyrule Ridge = تلال هايرول
Moblin Base = معسكر الموبلين
Woodland Region = منطقة الغابات
Akkala Highlands = مرتفعات أكالا
Akkala Mountain Range = سلسلة جبال أكالا
Stuhlbsnow Mountain = جبل ستولبسنو
Frostheim = فروستهايم
Dragonhead Island = جزيرة رأس التنين
Scales of Destiny = موازين القدر
Ruins of Shaskel = أطلال شاسكل
Rospro Pass = ممر روسبرو
Hebra North Summit = قمة هيبرا الشمالية
Hebra South Summit = قمة هيبرا الجنوبية
Hebra Castle = قلعة هيبرا
Old Man = الرجل العجوز
Great Sky Islet = جزيرة السماء الصغرى
Sky Tears = دموع السماء
Construct Factory = مصنع الآلات
Underground = تحت الأرض
Depths Entrance = مدخل الأعماق
The Construct = الآلة
Ancient Shrine = مزار قديم
Ancient Altar = مذبح قديم
Ancient Lab = مختبر قديم
Blessing = بركة
Divine Beast = وحش إلهي
Dungeon Boss = زعيم الزنزانة
Mini Boss = زعيم صغير
Enemy = عدو
NPC = شخصية غير لاعب
NPC Quest = مهمة الشخصيات
Gather = اجمع
Defeat = انتصر على
Deliver = وصّل
Reach = وصول إلى
Explore = استكشف
Discover = اكتشف
Unlock = افتح
Recover = استعد
Find = جد
Search = ابحث
Photograph = صور
Examine = افحص
Interact = تفاعل
Challenge = تحدٍ
Treasure Chest = صندوق الكنز
Gold Chest = صندوق ذهبي
Silver Chest = صندوق فضي
Wooden Chest = صندوق خشبي
Monster Camp = معسكر الوحوش
Fire Enemies = أعداء النار
Ice Enemies = أعداء الجليد
Electric Enemies = أعداء الكهرباء
Curse = لعنة
Blessed = مبارك
Ancient = قديم
Powerful = قوي
Rare = نادر
Common = عادي
Legendary = أسطوري
Mythical = خيالي
Holy = مقدس
Dark = مظلم
Sacred = مقدس
Cursed = ملعون
Blessed Weapon = سلاح مبارك
Cursed Weapon = سلاح ملعون
Monster Drops = أشياء الوحوش
Essence = جوهر
Power Gem = جوهرة القوة
Wisdom Gem = جوهرة الحكمة
Courage Gem = جوهرة الشجاعة
Dragon = تنين
Dragon Scale = حرشفة التنين
Dragon Horn = قرن التنين
Dragon Claw = مخلب التنين
Dinraal = دينرال
Naydra = نايدرا
Farosh = فاروش
Secret Shrine = مزار سري
Treasure Chest = صندوق الكنز الخفي
Hidden Shrine = مزار مخفي
Cheek = خد
Tear = دمعة
Crystallized Charge = شحنة متبلورة
Suspended = معلق
Stasis Pod = كبسولة التثبيت
Travel Medallion = ميدالية السفر
Ancient Arrow = سهم قديم
Ancient Blade = نصل قديم
Ancient Spear = رمح قديم
Ancient Shield = درع قديم
Ancient Gears = تروس قديمة
Ancient Springs = نوابض قديمة
Ancient Screw = برغي قديم
Ancient Shaft = عمود قديم
Ancient Core = نواة قديمة
Giant Ancient Core = نواة قديمة عملاقة
Ancient Arm = ذراع قديمة
Ancient Leg = ساق قديمة
Ancient Torso = جسم قديم
Ancient Head = رأس قديم
Goron = غورون
Goron City = مدينة الغورون
Goron Mines = مناجم الغورون
Goron Armor = دروع الغورون
Goron Tunic = سترة الغورون
Goron Greaves = واقي ساق الغورون
Goron Boots = حذاء الغورون
Fire Proof = مقاوم للنار
Heat Resistant = مقاوم للحرارة
Lava Harp = قيثارة الحمم
Daruk = داروك
Yunobo = يونوبو
Blazing Heroine = البطلة المتوهجة
Geyser = نافورة حرارية
Fire Dragon = تنين النار
Dinraal's Blessing = بركة دينرال
Molten = منصهر
Magma = حمم بركانية
Zora = زورا
Zora's Domain = مملكة الزورا
Zora Armor = دروع الزورا
Zora Tunic = سترة الزورا
Zora Greaves = واقي ساق الزورا
Zora Boots = حذاء الزورا
Water Proof = مقاوم للماء
Shock Resistant = مقاوم للكهرباء
Zora Helm = خوذة الزورا
Electric = كهربائي
Lightning = برق
Zora Spear = رمح الزورا
Trident = ثلاثية الشوكات
Electrical Arrows = أسهم كهربائية
Mipha = ميفا
Sidon = سيدون
Revali's Gale = هبة ريفالي
Water Dragon = تنين الماء
Naydra's Blessing = بركة نايدرا
Shock = صدمة كهربائية
Waterproof Armor = درع مقاوم للماء
Gerudo = غيرودو
Gerudo Town = بلدة الغيرودو
Gerudo Armor = دروع الغيرودو
Gerudo Outfit = ملابس الغيرودو
Gerudo Veil = نقاب الغيرودو
Gerudo Boots = حذاء الغيرودو
Desert Protection = حماية الصحراء
Heat Resistance = مقاومة الحرارة
Sand = رمل
Sand Boots = حذاء الرمل
Urbosa = أوربوسا
Urbosa's Fury = غضب أوربوسا
Lightning Strike = ضربة برق
Thunderblight = آفة الرعد
Scimitar = سيف منحني
Gerudo Spear = رمح الغيرودو
Rito = ريتو
Rito Village = قرية الريتو
Rito Armor = دروع الريتو
Rito Tunic = سترة الريتو
Rito Boots = حذاء الريتو
Feather = ريشة
Wind Resistance = مقاومة الريح
Sky Armor = درع السماء
Tulin = تولين
Revali = ريفالي
Gale = نسمة
Updraft = تيار صاعد
Wind = ريح
Glide = انزلاق
Divine Beast Vah = الوحش الإلهي فاه
Vah Ruta = فاه روتا
Vah Rudania = فاه رودانيا
Vah Medoh = فاه ميدوه
Vah Nabooris = فاه نابوريس
Terminal = طرفية
Module = وحدة
Control Unit = وحدة التحكم
Ancient Spring = نابض قديم
Ancient Gears = تروس قديمة
Decayed = متحلل
Rusty = صدئ
Broken = مكسور
Repaired = مصلح
Ancient Robot = روبوت قديم
Rusted Weapon = سلاح صدئ
Rusted Claymore = سيف عريض صدئ
Rusted Spear = رمح صدئ
Rusted Bow = قوس صدئ
Rusted Shield = درع صدئ
Royal Weapon = سلاح ملكي
Royal Guard = حراس ملكيون
Royal Broadsword = سيف ملكي عريض
Royal Claymore = سيف ملكي عريض
Royal Guard Spear = رمح حارس ملكي
Royal Guard Bow = قوس حارس ملكي
Royal Guard Shield = درع حارس ملكي
Royal Halberd = هالبرد ملكي
Elf Ears = آذان شبح
Gerudo Veil = نقاب الغيرودو
Servant's Bandages = عصابات الخادم
Insect Armor = درع الحشرات
Barbarian Armor = درع البرابرة
Climber's Armor = درع المتسلق
Cold Resistance Armor = درع مقاوم للبرد
Flame Guard Armor = درع حماية النار
Shock Resistant Armor = درع مقاوم للصدمة
Ancient Armor = درع قديم
Daybreaker = كاسر الفجر
Magic Rod = عصا سحرية
Fire Rod = عصا النار
Ice Rod = عصا الجليد
Lightning Rod = عصا البرق
Bomb Arrows = أسهم المتفجرات
Bomb Bow = قوس المتفجرات
Bomb Shield = درع متفجر
Bomb Rune = رمز المتفجرات
Fire Arrow = سهم ناري
Ice Arrow = سهم جليدي
Shock Arrow = سهم صدمة
Ancient Arrow = سهم قديم
Bomb = متفجر
Remote Bomb = متفجر بالتحكم
Round Bomb = متفجر كروي
Square Bomb = متفجر مربع
Bomb Flower = زهرة المتفجرات
Giant Bomb Flower = زهرة متفجرات عملاقة
Blast Fruit = فاكهة الانفجار
Chuchu = تشوتشو
Red Chuchu = تشوتشو أحمر
Blue Chuchu = تشوتشو أزرق
Yellow Chuchu = تشوتشو أصفر
Electric Chuchu = تشوتشو كهربائي
Fire Chuchu = تشوتشو ناري
Ice Chuchu = تشوتشو جليدي
Chuchu Jelly = جيلاتين تشوتشو
Chuchu Red = جيلاتين تشوتشو أحمر
Chuchu Blue = جيلاتين تشوتشو أزرق
Chuchu Yellow = جيلاتين تشوتشو أصفر
Slime = وحل
Stalkoblin = عظم بوكوبلين
Stalhnox = عظم هاينوكس
Stalmoblin = عظم موبلين
Skeleton = هيكل عظمي
Cursed = ملعون
Gloom = ظلام
Gloom Veil = حجاب الظلام
Tears of Light = دموع النور
Lightbulb = بصيلة نور
Sunflower = عباد الشمس
Spirit = روح
Phantom = شبح
Construct = آلة
Guardian = حارس
Ancient Guard = حارس قديم
Walking Guard = حارس سائر
Decayed Guard = حارس متحلل
Wheeled Guard = حارس بعجلات
Flying Guard = حارس طائر
Guardian Laser = ليزر الحارس
Guardian Gear = تروس الحارس
Guardian Spring = نابض الحارس
Guardian Shield = درع الحارس
Giant Guard = حارس عملاق
Minor Guardian = حارس صغير
Ruin = خراب
Crumble = تحطم
Ancient Nodes = عقد قديمة
Ancient Flower = زهرة قديمة
Ancient Nut = جوزة قديمة
Ancient Screw = برغي قديم
Ancient Rotor = دوار قديم
Ancient Shaft = عمود قديم
Cursed Armor = درع ملعون
Shadow = ظل
Twilight = الشفق
Blessed Armor = درع مبارك
Golden Armor = درع ذهبي
Silver Armor = درع فضي
Tattered Armor = درع ممزق
Ragged = مهترئ
Dusty = مغبر
Weathered = عتيق
Polished = لمعان
Crafted = مصنوع يدوياً
Forged = مطروق
Engraved = منقوش
Embossed = بارز
Inlaid = مرصع
Gilded = مذهب
Leatherbound = مجلد جلد
Wrapped = ملفوف
Coated = مغطى
Reinforced = معزز
Enchanted = مسحور
Cursed Item = شيء ملعون
Blessed Item = شيء مبارك
Legendary Item = شيء أسطوري
Mythical Item = شيء خيالي
Priceless = بلا ثمن
Invaluable = ثمين جداً
